##############################
#....#.......................#
#..$.#.....................$.#
#............?...............#
#............................#
#............................#
#....#########################
#....#.......................#
#....#.?...................$.#
#....#.......................#
#....#..................#....#
#....#.$................#....#
#....#..................#....#
#....#######......#######....#
#....#..................#....D
#....#..................#....D
#....#..........####....#....#
#...............#............#
#........?......#............#
#...............#............#
#....#########################
#....#................#......#
#....#.......................#
#....#.......................#
#............................#
#.....................#......#
#..........?..........#......#
#....#................#..$...#
#....#................#......#
##############################