##############################
#............................#
#..?.........................#
#............................#
####...##...........#........#
#........#..........#........#
#.........#....$..###......###
#.......$..#.....#...........#
#...........#...#............#
#............###.............#
#..?......................$..#
#............................#
############......############
#............................#
#............................D
#............................D
#............................#
####....##############....####
#.......#.................#..#
#.......#.?..............#...#
#.......#...............#..?.#
#.......#.......$......#.....#
#.......#.............#......#
#.......#............#.......#
#.......#......######..$.....#
#..............#.............#
#............................#
#.$..........................#
#.......#....................#
##############################