##############################
############......############
##########..........##########
########..............########
######........??........######
####......................####
##..........................##
#............................#
#......$..............$......#
#............................#
#............................#
#............................#
#............................#
#............................#
D............................#
D............................#
#............................#
#............................#
#............................#
#............................#
#............................#
#......$..............$......#
#............................#
##..........................##
####......................####
######........??........######
########..............########
##########..........##########
##########..........##########
############......############