##############################
#............................#
#..$......................$..#
#............................#
####....##############....####
#..........#.................#
#..........#.................#
#..........#.................#
#..........#.................#
#....$.....#..?..............#
#..........#.................#
#..........##############....#
#.......................#....#
#....................?..#....#
#......................##....#
#.........###############....#
#.........#..................#
#.........#..................#
######....#..................#
#.........#....##########....#
#.........#....###.$$.###....#
#.........#....###....###....#
#.........#....###....###....#
#.........#.....#......#.....#
#............................#
#............................#
#............................#
#.?..........................#
#.........#..................#
##############DD##############