##############################
#............................#
######.......................#
#............................#
#............................#
#......#########.............#
#............................#
#............................#
#............................#
#.......######################
#............................#
#............................#
#............................#
#............................#
#............................#
#.....############...........#
#............................#
#............................#
#............................#
#............................#
#............................#
#............................#
#............................#
###############..............#
#............................#
#............................#
#...............##############
#..........@.................#
#............................#
##############################