##############..##############
#............................#
#............................#
######...................!...#
#............................#
#......#########.............#
#............................#
#............................#
#............................#
#.......######################
#............................#
#............................#
..........................!...
..............................
#............................#
#.....############...........#
#............................#
#............................#
#............................#
#............................#
#............................#
#............................#
#............................#
###############..............#
#............................#
#............................#
#...............##############
#............................#
#............................#
##############..##############