##############################
#............................#
#............................#
#............................#
#............................#
#............................#
#............................#
#............................#
#............................#
#.......######################
#............................#
#............................#
#............................#
#............................#
#............................#
#.....############...........#
#............................#
#............................#
#............................#
#...........@................#
#............................#
#............................#
#............................#
###############..............#
#............................#
#............................#
#............................#
#............................#
#............................#
##############################