##############################
###################........###
#........##########........###
#........##########.......$###
#........##########........###
#.....?..##########........###
#........##.......#........###
#........##.......#........###
#........##................###
#........##.$.....#........###
#.................#...?....###
#........##..?....#........###
#........##.......#..$.....###
#........##?......#........###
#........#######.##........###
################.##........###
################.#############
################.#############
################.#############
###########...........########
###########...........########
###########...........########
###########...........########
###########...........########
###########...........########
###########...........########
###########...........########
###########....$......########
###########...........########
##############################