##############################
###################........###
#........##########........###
#........##########........###
#........##########........###
#........##########........###
#........##.......#........###
#.?......##.......#........###
#........##................###
#........##................###
#.................#........###
#.................#$.......###
#........##.......#........###
#........##.......#?.......###
#........#######..#...$....###
################..#........###
################..############
################.$############
################..############
###########...........########
###########...........########
###########..........$########
###########...........########
###########...........########
###########.......?...########
###########..........$########
###########...........########
###########...........########
###########...........########
##############################